1111111111111111111111111111111111111111111111111111111111111111111111111111111111111111111111111111
1111111111111111111111111111111111111111111111111111111111111111111111111111111111111111111111111111
1111111111111111100000000000000000000000000000000000000000000000000000000000000000011111111111111111
1111111111111110000000000000000000000000000000000000000000000000000000000000000000000111111111111111
1111111111111000000000000000000000000000000000000000000000000000000000000000000000000001111111111111
1111111111000000000000000000000000000000000000000000000000000000000000000000000000000000001111111111
1111111110000000000000000000000000000000000000000000000000000000000000000000000000000000000111111111
1111111100000000000000000000000000000000000000000000000000000000000001111000000000000000000011111111
1111111000000000000000000000000000000000000000000000000000000000001111111000000000000000000001111111
1111110000000000000000000011111111111111111100000011111111111111111111111000000000000000000000111111
1111110000000000000001000011111111111111111110000011111111111111111000111000000000000000000000111111
1111100000000000000011100001111111111111111110000011111111111111110000111100000000000000000000011111
1111000000000000000011110000111111111111111100000000111111111111100000011100000000000000000000001111
1111000000000000000001111000111111111111110000000000000011111111000000011100000000000000000000001111
1111000000000000000001111000011111110011100000000000000000011100000000011110000000000000000000001111
1110000000000000000000111100000111110000000000000000000000000000000000001111000000000000000000000111
1110000000000000000000011100000011110000000000111000000000000000011100001111100000000000000000000111
1110000000000000000000000000000000110000000011111000000000000000111110011111100000000000000000000111
1110000000000000000000000000000000000000000011110000000000000111111111111111000000000000000000000111
1110000000001110000000000000011000000000000111100000010000001111111111110000000000000000000000000111
1100000000011111000000000000111100000000001111100000111000001111111111000000000000000000000000000011
1100000000011111100000000011111110000000001111110011111000001111111110000000000000000000000000000011
1100000000111111110000000111111111111000001111111111110000011111111100000000000000000000000000000011
1100000000111111110000000011111111111100001111111111100000011111111110000000000011000000000000000011
1100000000111111111000000011111111111110000111111111000000011111111110000000000011111000000000000011
1100000001111111111100000001111111111111000011111000000000011111111110000000000111111110000000000011
1100000001111111111100000001111111111111100000000000000000001111111100000000001111111111100000000011
1100000001111111111110000001111111111111100000000000000100000111111100000000011100011111111110000011
1100000001111100001110000000111111111111100000000000000110000011100000000000111000000111111110000011
1100000001111000001110000000111111111111100000000000000111100000000000000000111000000001111110000011
1100000001111000000111000000111111111111110000000111001111110000000000000001111100000000011110000011
1100000000110000000011000000011111111111111100001111111111111000000000000001111110000000001110000011
1100000000000000000011000000001111111111111100000111111111111100000000000011111111110000001110000011
1100000000000001100001000000000111111111110000000111111111111000000000000111111111110000011100000011
1100000000000011110000000000000111111110000000000111111111110000000000001111111111100000111100000011
1100000000011111110000000000000000110000000000000011111111100000000000001111111111000001111100000011
1100000000111111111000000000000000000000000000000000111111000000000000000111111111000001111100000011
1100000001111111111000000110000000000000000011110000001111000000000000000001111111000001111100000011
1100000001111111111000000111000000000000000011111000000000000000000000000001111111100001111100000011
1100000001111100011100000111100000000000000001111100000000000000001110000001111111100001111100000011
1100000001111000011110000011110000000000000000111110000000000000001111000011111111110001111100000011
1100000001111000001111000011111100000000000000011111000000000000111110000011111111110001111100000011
1100000001111000001111100001111100000000000000001111000000000001111110000011111111110001111100000011
1100000001111000000111100001111100000000000000000111111000000111111110000011111111000001111100000011
1100000001111000000011100000111100000000000000000001111111001111111110000001111100000001111100000011
1100000001111110000000000000111100011110000000000000011111111111111100000000000000000001111100000011
1100000001111111000000000000111100111111100000000000000001111111111100000000000000000001111100000011
1100000000111111100000000000011100111111110000000000000000000111111000011111111000000000111100000011
1100000000111111110000000000011100000111111000000000000000000000000000111111111100000000000000000011
1100000000001111110000000000011100000001111100000000000000000000000001111111111100001110000000000011
1100000000000111110000111111111100000000111110000000000001111000000001111101111100011111000000000011
1100000000000000000001111111111100000000011100000000000001111100000001110000000000011111100000000011
1100000000000000000001111111111000000000000000000000000000111111100001110000000000011111111000000011
1100000000100000000000111111111000111100000000000000000000011111110000111000000000001111111100000011
1100000001110000000000000000000001111110000000000000000000000111111000111000000000000111111100000011
1100000001111000000000000000000001111111111100000000000000000000111000111100000000000111111100000011
1100000001111000000011111110000001111111111111111000000000000000000000111100000110000001111100000011
1100000001111000001111111111000001111111111111111111000000000000000000111110000111000001111100000011
1100000001111000001111111111000011111000000000011111110000000000000001111110000111100001111100000011
1100000001111100001111111111000011110000000000000111111000000000000001111110000111100000111100000011
1100000001111100001111111111000111100000000000000001111000000000000000011111000001110000111100000011
1100000001111000000111111111000111000000000000000000111100000000000000000111000001110001111100000011
1100000001111000000011111110000000000000000000000000011110000000000000000111100000111001111100000011
1100000001111100000011111110000000000000000000000000001110001110000000000011100000111001111100000011
1100000001111100000111111111000000000000000111111100001100001111100000000000000000011001111000000011
1100000001111100000111111111100000000000001111111110000000000111110000000000000000011001110000000011
1100000001111000011111111111100000000000111111111111000000000011111100000000000000111000000000000011
1100000001110000011111111111000000000000111111111111000000001111111111000000000011111100000000000011
1100000011110000001111111110000000000000011111111111100001111111111111100000000111111000000000000011
1100000011111000000011111100000000000000000111011111100001111111111111110000000111110000111000000011
1100000011111000000001111000000000000000000011000111100000111111111111110000000011110000111100000011
1100000011111110000000110000000000000000000011000000000000001111111111111000000011100000111100000011
1100000011111111100001110000000000111110000011000000000000001111111111111000000011110001111100000011
1100000001111111110011110000000000111111100001000000000000001111111111111100000001110001111100000011
1100000000000111111111100000000011111111110000000000000000000111111111111100000001111111111100000011
1100000000000001111110000000000111111111110000000000111100000011111111111100000000111111111100000011
1100000000000000111100000000001111111111110000000011111111100011111111111110000000011111111000000011
1100000000000000011000000000001111111111110000000111111111100001111111111110000000011111111000000011
1100000000000000000000000000011111111111110000001111111111100000011111111111000000001111111000000011
1100000000000000000000000000111111111111110000011110011111100000000001111110000000000111111000000011
1110000000000000000000000001111011111111100000011000011111100000000000111100000000000011110000000111
1110000000000000000000000111100011111111100000000000001111000000000000000000000000000001100000000111
1110000000000000000000011111000001111111100000000000011111000000000000000000000000000000000000000111
1110000000000000000000001111000001111110000000000000011110000000011000000000111100000000000000000111
1110000000000000000000001111100000111000000000000000111100000000011110000011111110000000000000000111
1111000000000000000000000111110000110000000000000000000000000000011111100111111110000000000000001111
1111000000000000000000000011110000000000000000000000000000001111011111111111111110000000000000001111
1111000000000000000000000001110000000001111111000000000000001111111111111111111110000000000000001111
1111100000000000000000000001110000000111111111111000000000111111111111111111111110000000000000011111
1111110000000000000000000001111110011111111111111110000011111111111111111111111110000000000000111111
1111110000000000000000000000111111111111111111111111000011111111111111111111111100000000000000111111
1111111000000000000000000000111111111111111111111111000001111111111111111111111000000000000001111111
1111111100000000000000000000111110000000000000000000000000000000000000000000000000000000000011111111
1111111110000000000000000000111000000000000000000000000000000000000000000000000000000000000111111111
1111111111000000000000000000000000000000000000000000000000000000000000000000000000000000001111111111
1111111111111000000000000000000000000000000000000000000000000000000000000000000000000001111111111111
1111111111111110000000000000000000000000000000000000000000000000000000000000000000000111111111111111
1111111111111111100000000000000000000000000000000000000000000000000000000000000000011111111111111111
1111111111111111111111111111111111111111111111111111111111111111111111111111111111111111111111111111
1111111111111111111111111111111111111111111111111111111111111111111111111111111111111111111111111111

